111111111111111111111111
10C1000000J0000010000001
1001C00C00000C0010000001
1J0100000000010110000001
10P0011111000100000E0001
10C10000C100010000000001
111111111111111111111111
