11111111
1P0EJC01
10000CJ1
10JJJ001
11111111