11111111111111
1P000000CE0001
11111111111111