11111111111111
1PCE0J00000001
11111111111111