1111111111111111111111
1000000000000000000001
100P000J000C00000E0001
1000000000000000000001
1000000000000000000001
1111111111111111111111