11111111111111111111111
1J000000000100JC1000J01
1P000E00010J00001C10001
10000000000000J00001001
10001JC10000J0000100001
10011000110100JJ1000001
10010CC001000000J000001
11111111111111111111111