11111111111111111
10000000000000001
1000000000000J001
10000000000000001
1P00000C000E00001
10000000000000001
10000000000000001
10000000000000001
11111111111111111