111111111111111
10C0C011111CCC1
100J00011100C01
10000000100J001
100000J0P0J00E1
10000000100J001
100J00011100C01
10C0C011111CCC1
111111111111111