111111111111111
10P0C0C0C0C0C01
1111111111J0111
10C0C0C0C0C0C01
1111J0111111111
100000J00000001
1C0C0C0C0C0C001
11111111J011111
10C0C0C0C010C01
110J1C0C011C001
100011J011C0C01
10E01C0C0C0C0C1
111111111111111