11111111
10P00001
100C01E1
11111111